2560
1280
00000000000000000000000000000000000000000000000000000000000000000000000000000000
03333333333333333303333333333333333333300333333333333333330333333333333333333330
03333333453333333303333333333333333333300333333345333333330333333333333333333330
03333333673333333303333333333333333333300333333367333333330333333333333333333330
03333333333333333333333333333333333333300333333333333333333333333333333333333330
03333333333333333333333333333033333333300333333333333333333333333333303333333330
00000033333000000003333333330033333333300000003333300000000333333333003333333330
03333333333333333303333333300033333333300333333333333333330333333330003333333330
03333333333333333303333333333333333333333333333333333333330333333333333333333330
03333333333333333303333333333333333333333333333333333333330333333333333333333330
03333333333333333303333333333333333333333333333333333333330333333333333333333330
03333333333333333303333333333003333333333333333333333333330333333333300333333330
03333333333333333303333333333003333333300333333333333333330333333333300333333330
03333333333333333303333333333333333333300333333333333333330333333333333333333330
03333333333333333303333333333333333333300333333333333333330333333333333333333330
03333333333333333303333333333333333333300333333333333333330333333333333333333330
03333333333333333333333333333333333333300333333333333333333333333333333333333330
03333333333333333333333333333333333333300333333333333333333333333333333333333330
03333333333333333333333333333333333333300333333333333333333333333333333333333330
03333333333333333333333333333333333333333333333333333333333333333333333333333330
03333333333333333333333333333333333333333333333333333333333333333333333333333330
03333333333333333333333333333333333333333333333333333333333333333333333333333330
03333333333333333333333333333333333333333333333333333333333333333333333333333330
03333333333333333333333333333333333333300333333333333333333333333333333333333330
03333333333333333333333333333333333333300333333333333333333333333333333333333330
03333333333333333333333333333333333333300333333333333333333333333333333333333330
03333333333333333333333333333333333333300333333333333333333333333333333333333330
03333333333333333333333333333333333333300333333333333333333333333333333333333330
03333333333333333333333333333333333333300333333333333333333333333333333333333330
03333333333333333333333333333333333333300333333333333333333333333333333333333330
03333333333333333333333333333333333333300333333333333333333333333333333333333330
03333333333333333333333333333333333333300333333333333333333333333333333333333330
03333333333333333333333333333333333333300333333333333333333333333333333333333330
03333333333333333333333333333333333333300333333333333333333333333333333333333330
03333333333333333333333333333333333333300333333333333333333333333333333333333330
03333333333333333333333333333333333333300333333333333333333333333333333333333330
03333333333333333333333333333333333333300333333333333333333333333333333333333330
03333333333333333333333333333333333333300333333333333333333333333333333333333330
03333333333333333333333333333333333333300333333333333333333333333333333333333330
00000000000000000000000000000000000000000000000000000000000000000000000000000000