2560
1280
0x0-1|0x0-1|0x0-1|0x0-1|0x0-1|0x0-1|0x0-1|0x0-1|0x0-1|0x0-1|0x0-1|0x0-1|0x0-1|0x0-1|0x0-1|0x0-1|0x0-1|0x0-1|0x0-1|0x0-1|0x0-1|0x0-1|0x0-1|0x0-1|0x0-1|0x0-1|0x0-1|0x0-1|0x0-1|0x0-1|0x0-1|0x0-1|0x0-1|0x0-1|0x0-1|0x0-1|0x0-1|0x0-1|0x0-1|0x0-1|0x0-1|0x0-1|0x0-1|0x0-1|0x0-1|0x0-1|0x0-1|0x0-1|0x0-1|0x0-1|0x0-1|0x0-1|0x0-1|0x0-1|0x0-1|0x0-1|0x0-1|0x0-1|0x0-1|0x0-1|0x0-1|0x0-1|0x0-1|0x0-1|0x0-1|0x0-1|0x0-1|0x0-1|0x0-1|0x0-1|0x0-1|0x0-1|0x0-1|0x0-1|0x0-1|0x0-1|0x0-1|0x0-1|0x0-1|0x0-1|
0x0-1|3x0-0|3x0-0|3x0-0|3x0-0|3x0-0|3x0-0|3x0-0|3x0-0|3x0-0|3x0-0|3x0-0|3x0-0|3x0-0|3x0-0|3x0-0|3x0-0|3x0-0|0x0-1|3x0-0|3x0-0|3x0-0|3x0-0|3x0-0|3x0-0|3x0-0|3x0-0|3x0-0|3x0-0|3x0-0|3x0-0|3x0-0|3x0-0|3x0-0|3x0-0|3x0-0|3x0-0|3x0-0|3x0-0|0x0-1|0x0-1|3x0-0|3x0-0|3x0-0|3x0-0|3x0-0|3x0-0|3x0-0|3x0-0|3x0-0|3x0-0|3x0-0|3x0-0|3x0-0|3x0-0|3x0-0|3x0-0|3x0-0|0x0-1|3x0-0|3x0-0|3x0-0|3x0-0|3x0-0|3x0-0|3x0-0|3x0-0|3x0-0|3x0-0|3x0-0|3x0-0|3x0-0|3x0-0|3x0-0|3x0-0|3x0-0|3x0-0|3x0-0|3x0-0|0x0-1|
0x0-1|3x0-0|3x0-0|3x0-0|3x0-0|3x0-0|3x0-0|3x0-0|4x0-0|5x0-0|3x0-0|3x0-0|3x0-0|3x0-0|3x0-0|3x0-0|3x0-0|3x0-0|0x0-1|3x0-0|3x0-0|3x0-0|3x0-0|3x0-0|3x0-0|3x0-0|3x0-0|3x0-0|3x0-0|3x0-0|3x0-0|3x0-0|3x0-0|3x0-0|3x0-0|3x0-0|3x0-0|3x0-0|3x0-0|0x0-1|0x0-1|3x0-0|3x0-0|3x0-0|3x0-0|3x0-0|3x0-0|3x0-0|4x0-0|5x0-0|3x0-0|3x0-0|3x0-0|3x0-0|3x0-0|3x0-0|3x0-0|3x0-0|0x0-1|3x0-0|3x0-0|3x0-0|3x0-0|3x0-0|3x0-0|3x0-0|3x0-0|3x0-0|3x0-0|3x0-0|3x0-0|3x0-0|3x0-0|3x0-0|3x0-0|3x0-0|3x0-0|3x0-0|3x0-0|0x0-1|
0x0-1|3x0-0|3x0-0|3x0-0|3x0-0|3x0-0|3x0-0|3x0-0|6x0-0|7x0-0|3x0-0|3x0-0|3x0-0|3x0-0|3x0-0|3x0-0|3x0-0|3x0-0|0x0-1|3x0-0|3x0-0|3x0-0|3x0-0|3x0-0|3x0-0|3x0-0|3x0-0|3x0-0|3x0-0|3x0-0|3x0-0|3x0-0|3x0-0|3x0-0|3x0-0|3x0-0|3x0-0|3x0-0|3x0-0|0x0-1|0x0-1|3x0-0|3x0-0|3x0-0|3x0-0|3x0-0|3x0-0|3x0-0|6x0-0|7x0-0|3x0-0|3x0-0|3x0-0|3x0-0|3x0-0|3x0-0|3x0-0|3x0-0|0x0-1|3x0-0|3x0-0|3x0-0|3x0-0|3x0-0|3x0-0|3x0-0|3x0-0|3x0-0|3x0-0|3x0-0|3x0-0|3x0-0|3x0-0|3x0-0|3x0-0|3x0-0|3x0-0|3x0-0|3x0-0|0x0-1|
0x0-1|3x0-0|3x0-0|3x0-0|3x0-0|3x0-0|3x0-0|3x0-0|3x0-0|3x0-0|3x0-0|3x0-0|3x0-0|3x0-0|3x0-0|3x0-0|3x0-0|3x0-0|3x0-0|3x0-0|3x0-0|3x0-0|3x0-0|3x0-0|3x0-0|3x0-0|3x0-0|3x0-0|3x0-0|3x0-0|3x0-0|3x0-0|3x0-0|3x0-0|3x0-0|3x0-0|3x0-0|3x0-0|3x0-0|0x0-1|0x0-1|3x0-0|3x0-0|3x0-0|3x0-0|3x0-0|3x0-0|3x0-0|3x0-0|3x0-0|3x0-0|3x0-0|3x0-0|3x0-0|3x0-0|3x0-0|3x0-0|3x0-0|3x0-0|3x0-0|3x0-0|3x0-0|3x0-0|3x0-0|3x0-0|3x0-0|3x0-0|3x0-0|3x0-0|3x0-0|3x0-0|3x0-0|3x0-0|3x0-0|3x0-0|3x0-0|3x0-0|3x0-0|3x0-0|0x0-1|
0x0-1|3x0-0|3x0-0|3x0-0|3x0-0|3x0-0|3x0-0|3x0-0|3x0-0|3x0-0|3x0-0|3x0-0|3x0-0|3x0-0|3x0-0|3x0-0|3x0-0|3x0-0|3x0-0|3x0-0|3x0-0|3x0-0|3x0-0|3x0-0|3x0-0|3x0-0|3x0-0|3x0-0|3x0-0|0x0-1|3x0-0|3x0-0|3x0-0|3x0-0|3x0-0|3x0-0|3x0-0|3x0-0|3x0-0|0x0-1|0x0-1|3x0-0|3x0-0|3x0-0|3x0-0|3x0-0|3x0-0|3x0-0|3x0-0|3x0-0|3x0-0|3x0-0|3x0-0|3x0-0|3x0-0|3x0-0|3x0-0|3x0-0|3x0-0|3x0-0|3x0-0|3x0-0|3x0-0|3x0-0|3x0-0|3x0-0|3x0-0|3x0-0|3x0-0|0x0-1|3x0-0|3x0-0|3x0-0|3x0-0|3x0-0|3x0-0|3x0-0|3x0-0|3x0-0|0x0-1|
0x0-1|0x0-1|0x0-1|0x0-1|0x0-1|0x0-1|3x0-0|3x0-0|3x0-0|3x0-0|3x0-0|0x0-1|0x0-1|0x0-1|0x0-1|0x0-1|0x0-1|0x0-1|0x0-1|3x0-0|3x0-0|3x0-0|3x0-0|3x0-0|3x0-0|3x0-0|3x0-0|3x0-0|0x0-1|0x0-1|3x0-0|3x0-0|3x0-0|3x0-0|3x0-0|3x0-0|3x0-0|3x0-0|3x0-0|0x0-1|0x0-1|0x0-1|0x0-1|0x0-1|0x0-1|0x0-1|3x0-0|3x0-0|3x0-0|3x0-0|3x0-0|0x0-1|0x0-1|0x0-1|0x0-1|0x0-1|0x0-1|0x0-1|0x0-1|3x0-0|3x0-0|3x0-0|3x0-0|3x0-0|3x0-0|3x0-0|3x0-0|3x0-0|0x0-1|0x0-1|3x0-0|3x0-0|3x0-0|3x0-0|3x0-0|3x0-0|3x0-0|3x0-0|3x0-0|0x0-1|
0x0-1|3x0-0|3x0-0|3x0-0|3x0-0|3x0-0|3x0-0|3x0-0|3x0-0|3x0-0|3x0-0|3x0-0|3x0-0|3x0-0|3x0-0|3x0-0|3x0-0|3x0-0|0x0-1|3x0-0|3x0-0|3x0-0|3x0-0|3x0-0|3x0-0|3x0-0|3x0-0|0x0-1|0x0-1|0x0-1|3x0-0|3x0-0|3x0-0|3x0-0|3x0-0|3x0-0|3x0-0|3x0-0|3x0-0|0x0-1|0x0-1|3x0-0|3x0-0|3x0-0|3x0-0|3x0-0|3x0-0|3x0-0|3x0-0|3x0-0|3x0-0|3x0-0|3x0-0|3x0-0|3x0-0|3x0-0|3x0-0|3x0-0|0x0-1|3x0-0|3x0-0|3x0-0|3x0-0|3x0-0|3x0-0|3x0-0|3x0-0|0x0-1|0x0-1|0x0-1|3x0-0|3x0-0|3x0-0|3x0-0|3x0-0|3x0-0|3x0-0|3x0-0|3x0-0|0x0-1|
0x0-1|3x0-0|3x0-0|3x0-0|3x0-0|3x0-0|3x0-0|3x0-0|3x0-0|3x0-0|3x0-0|3x0-0|3x0-0|3x0-0|3x0-0|3x0-0|3x0-0|3x0-0|0x0-1|3x0-0|3x0-0|3x0-0|3x0-0|3x0-0|3x0-0|3x0-0|3x0-0|3x0-0|3x0-0|3x0-0|3x0-0|3x0-0|3x0-0|3x0-0|3x0-0|3x0-0|3x0-0|3x0-0|3x0-0|3x0-0|3x0-0|3x0-0|3x0-0|3x0-0|3x0-0|3x0-0|3x0-0|3x0-0|3x0-0|3x0-0|3x0-0|3x0-0|3x0-0|3x0-0|3x0-0|3x0-0|3x0-0|3x0-0|0x0-1|3x0-0|3x0-0|3x0-0|3x0-0|3x0-0|3x0-0|3x0-0|3x0-0|3x0-0|3x0-0|3x0-0|3x0-0|3x0-0|3x0-0|3x0-0|3x0-0|3x0-0|3x0-0|3x0-0|3x0-0|0x0-1|
0x0-1|3x0-0|3x0-0|3x0-0|3x0-0|0x5-0|0x5-0|3x0-0|3x0-0|3x0-0|3x0-0|3x0-0|3x0-0|3x0-0|3x0-0|3x0-0|3x0-0|3x0-0|0x0-1|3x0-0|3x0-0|3x0-0|3x0-0|3x0-0|3x0-0|3x0-0|3x0-0|3x0-0|3x0-0|3x0-0|3x0-0|3x0-0|3x0-0|3x0-0|3x0-0|3x0-0|3x0-0|3x0-0|3x0-0|3x0-0|3x0-0|3x0-0|3x0-0|3x0-0|3x0-0|3x0-0|3x0-0|3x0-0|3x0-0|3x0-0|3x0-0|3x0-0|3x0-0|3x0-0|3x0-0|3x0-0|3x0-0|3x0-0|0x0-1|3x0-0|3x0-0|3x0-0|3x0-0|3x0-0|3x0-0|3x0-0|3x0-0|3x0-0|3x0-0|3x0-0|3x0-0|3x0-0|3x0-0|3x0-0|3x0-0|3x0-0|3x0-0|3x0-0|3x0-0|0x0-1|
0x0-1|3x0-0|3x0-0|3x0-0|3x0-0|1x5-0|3x0-0|3x0-0|3x0-0|3x0-0|3x0-0|3x0-0|3x0-0|3x0-0|3x0-0|3x0-0|3x0-0|3x0-0|0x0-1|3x0-0|3x0-0|3x0-0|3x0-0|3x0-0|3x0-0|3x0-0|3x0-0|3x0-0|3x0-0|3x0-0|3x0-0|3x0-0|3x0-0|3x0-0|3x0-0|3x0-0|3x0-0|3x0-0|3x0-0|3x0-0|3x0-0|3x0-0|3x0-0|3x0-0|3x0-0|3x0-0|3x0-0|3x0-0|3x0-0|3x0-0|3x0-0|3x0-0|3x0-0|3x0-0|3x0-0|3x0-0|3x0-0|3x0-0|0x0-1|3x0-0|3x0-0|3x0-0|3x0-0|3x0-0|3x0-0|3x0-0|3x0-0|3x0-0|3x0-0|3x0-0|3x0-0|3x0-0|3x0-0|3x0-0|3x0-0|3x0-0|3x0-0|3x0-0|3x0-0|0x0-1|
0x0-1|3x0-0|3x0-0|3x0-0|3x0-0|3x0-0|3x0-0|3x0-0|3x0-0|3x0-0|3x0-0|3x0-0|3x0-0|3x0-0|3x0-0|3x0-0|3x0-0|3x0-0|0x0-1|3x0-0|3x0-0|3x0-0|3x0-0|3x0-0|3x0-0|3x0-0|3x0-0|3x0-0|3x0-0|0x0-1|0x0-1|3x0-0|3x0-0|3x0-0|3x0-0|3x0-0|3x0-0|3x0-0|3x0-0|3x0-0|3x0-0|3x0-0|3x0-0|3x0-0|3x0-0|3x0-0|3x0-0|3x0-0|3x0-0|3x0-0|3x0-0|3x0-0|3x0-0|3x0-0|3x0-0|3x0-0|3x0-0|3x0-0|0x0-1|3x0-0|3x0-0|3x0-0|3x0-0|3x0-0|3x0-0|3x0-0|3x0-0|3x0-0|3x0-0|0x0-1|0x0-1|3x0-0|3x0-0|3x0-0|3x0-0|3x0-0|3x0-0|3x0-0|3x0-0|0x0-1|
0x0-1|3x0-0|3x0-0|3x0-0|3x0-0|3x0-0|3x0-0|3x0-0|3x0-0|3x0-0|3x0-0|3x0-0|3x0-0|3x0-0|3x0-0|3x0-0|3x0-0|3x0-0|0x0-1|3x0-0|3x0-0|3x0-0|3x0-0|3x0-0|3x0-0|3x0-0|3x0-0|3x0-0|3x0-0|0x0-1|0x0-1|3x0-0|3x0-0|3x0-0|3x0-0|3x0-0|3x0-0|3x0-0|3x0-0|0x0-1|0x0-1|3x0-0|3x0-0|3x0-0|3x0-0|3x0-0|3x0-0|3x0-0|3x0-0|3x0-0|3x0-0|3x0-0|3x0-0|3x0-0|3x0-0|3x0-0|3x0-0|3x0-0|0x0-1|3x0-0|3x0-0|3x0-0|3x0-0|3x0-0|3x0-0|3x0-0|3x0-0|3x0-0|3x0-0|0x0-1|0x0-1|3x0-0|3x0-0|3x0-0|3x0-0|3x0-0|3x0-0|3x0-0|3x0-0|0x0-1|
0x0-1|3x0-0|3x0-0|3x0-0|3x0-0|3x0-0|3x0-0|3x0-0|3x0-0|3x0-0|3x0-0|3x0-0|3x0-0|3x0-0|3x0-0|3x0-0|3x0-0|3x0-0|0x0-1|3x0-0|3x0-0|3x0-0|3x0-0|3x0-0|3x0-0|3x0-0|3x0-0|3x0-0|3x0-0|3x0-0|3x0-0|3x0-0|3x0-0|3x0-0|3x0-0|3x0-0|3x0-0|3x0-0|3x0-0|0x0-1|0x0-1|3x0-0|3x0-0|3x0-0|3x0-0|3x0-0|3x0-0|3x0-0|3x0-0|3x0-0|3x0-0|3x0-0|3x0-0|3x0-0|3x0-0|3x0-0|3x0-0|3x0-0|0x0-1|3x0-0|3x0-0|3x0-0|3x0-0|3x0-0|3x0-0|3x0-0|3x0-0|3x0-0|3x0-0|3x0-0|3x0-0|3x0-0|3x0-0|3x0-0|3x0-0|3x0-0|3x0-0|3x0-0|3x0-0|0x0-1|
0x0-1|3x0-0|3x0-0|3x0-0|3x0-0|3x0-0|3x0-0|3x0-0|3x0-0|3x0-0|3x0-0|3x0-0|3x0-0|3x0-0|3x0-0|3x0-0|3x0-0|3x0-0|0x0-1|3x0-0|3x0-0|3x0-0|3x0-0|3x0-0|3x0-0|3x0-0|3x0-0|3x0-0|3x0-0|3x0-0|3x0-0|3x0-0|3x0-0|3x0-0|3x0-0|3x0-0|3x0-0|3x0-0|3x0-0|0x0-1|0x0-1|3x0-0|3x0-0|3x0-0|3x0-0|3x0-0|3x0-0|3x0-0|3x0-0|3x0-0|3x0-0|3x0-0|3x0-0|3x0-0|3x0-0|3x0-0|3x0-0|3x0-0|0x0-1|3x0-0|3x0-0|3x0-0|3x0-0|3x0-0|3x0-0|3x0-0|3x0-0|3x0-0|3x0-0|3x0-0|3x0-0|3x0-0|3x0-0|3x0-0|3x0-0|3x0-0|3x0-0|3x0-0|3x0-0|0x0-1|
0x0-1|3x0-0|3x0-0|3x0-0|3x0-0|3x0-0|3x0-0|3x0-0|3x0-0|3x0-0|3x0-0|3x0-0|3x0-0|3x0-0|3x0-0|3x0-0|3x0-0|3x0-0|0x0-1|3x0-0|3x0-0|3x0-0|3x0-0|3x0-0|3x0-0|3x0-0|3x0-0|3x0-0|3x0-0|3x0-0|3x0-0|3x0-0|3x0-0|3x0-0|3x0-0|3x0-0|3x0-0|3x0-0|3x0-0|0x0-1|0x0-1|3x0-0|3x0-0|3x0-0|3x0-0|3x0-0|3x0-0|3x0-0|3x0-0|3x0-0|3x0-0|3x0-0|3x0-0|3x0-0|3x0-0|3x0-0|3x0-0|3x0-0|0x0-1|3x0-0|3x0-0|3x0-0|3x0-0|3x0-0|3x0-0|3x0-0|3x0-0|3x0-0|3x0-0|3x0-0|3x0-0|3x0-0|3x0-0|3x0-0|3x0-0|3x0-0|3x0-0|3x0-0|3x0-0|0x0-1|
0x0-1|3x0-0|3x0-0|3x0-0|3x0-0|3x0-0|3x0-0|3x0-0|3x0-0|3x0-0|3x0-0|3x0-0|3x0-0|3x0-0|3x0-0|3x0-0|3x0-0|3x0-0|3x0-0|3x0-0|3x0-0|3x0-0|3x0-0|3x0-0|3x0-0|3x0-0|3x0-0|3x0-0|3x0-0|3x0-0|3x0-0|3x0-0|3x0-0|3x0-0|3x0-0|3x0-0|3x0-0|3x0-0|3x0-0|0x0-1|0x0-1|3x0-0|3x0-0|3x0-0|3x0-0|3x0-0|3x0-0|3x0-0|3x0-0|3x0-0|3x0-0|3x0-0|3x0-0|3x0-0|3x0-0|3x0-0|3x0-0|3x0-0|3x0-0|3x0-0|3x0-0|3x0-0|3x0-0|3x0-0|3x0-0|3x0-0|3x0-0|3x0-0|3x0-0|3x0-0|3x0-0|3x0-0|3x0-0|3x0-0|3x0-0|3x0-0|3x0-0|3x0-0|3x0-0|0x0-1|
0x0-1|3x0-0|3x0-0|3x0-0|3x0-0|3x0-0|3x0-0|3x0-0|3x0-0|3x0-0|3x0-0|3x0-0|3x0-0|3x0-0|3x0-0|3x0-0|3x0-0|3x0-0|3x0-0|3x0-0|3x0-0|3x0-0|3x0-0|3x0-0|3x0-0|3x0-0|3x0-0|3x0-0|3x0-0|3x0-0|3x0-0|3x0-0|3x0-0|3x0-0|3x0-0|3x0-0|3x0-0|3x0-0|3x0-0|0x0-1|0x0-1|3x0-0|3x0-0|3x0-0|3x0-0|3x0-0|3x0-0|3x0-0|3x0-0|3x0-0|3x0-0|3x0-0|3x0-0|3x0-0|3x0-0|3x0-0|3x0-0|3x0-0|3x0-0|3x0-0|3x0-0|3x0-0|3x0-0|3x0-0|3x0-0|3x0-0|3x0-0|3x0-0|3x0-0|3x0-0|3x0-0|3x0-0|3x0-0|3x0-0|3x0-0|3x0-0|3x0-0|3x0-0|3x0-0|0x0-1|
0x0-1|3x0-0|3x0-0|3x0-0|3x0-0|3x0-0|3x0-0|3x0-0|3x0-0|3x0-0|3x0-0|3x0-0|3x0-0|3x0-0|3x0-0|3x0-0|3x0-0|3x0-0|3x0-0|3x0-0|3x0-0|3x0-0|3x0-0|3x0-0|3x0-0|3x0-0|3x0-0|3x0-0|3x0-0|3x0-0|3x0-0|3x0-0|3x0-0|3x0-0|3x0-0|3x0-0|3x0-0|3x0-0|3x0-0|0x0-1|0x0-1|3x0-0|3x0-0|3x0-0|3x0-0|3x0-0|3x0-0|3x0-0|3x0-0|3x0-0|3x0-0|3x0-0|3x0-0|3x0-0|3x0-0|3x0-0|3x0-0|3x0-0|3x0-0|3x0-0|3x0-0|3x0-0|3x0-0|3x0-0|3x0-0|3x0-0|3x0-0|3x0-0|3x0-0|3x0-0|3x0-0|3x0-0|3x0-0|3x0-0|3x0-0|3x0-0|3x0-0|3x0-0|3x0-0|0x0-1|
0x0-1|3x0-0|3x0-0|3x0-0|3x0-0|3x0-0|3x0-0|3x0-0|3x0-0|3x0-0|3x0-0|3x0-0|3x0-0|3x0-0|3x0-0|3x0-0|3x0-0|3x0-0|3x0-0|3x0-0|3x0-0|3x0-0|3x0-0|3x0-0|3x0-0|3x0-0|3x0-0|3x0-0|3x0-0|3x0-0|3x0-0|3x0-0|3x0-0|3x0-0|3x0-0|3x0-0|3x0-0|3x0-0|3x0-0|3x0-0|3x0-0|3x0-0|3x0-0|3x0-0|3x0-0|3x0-0|3x0-0|3x0-0|3x0-0|3x0-0|3x0-0|3x0-0|3x0-0|3x0-0|3x0-0|3x0-0|3x0-0|3x0-0|3x0-0|3x0-0|3x0-0|3x0-0|3x0-0|3x0-0|3x0-0|3x0-0|3x0-0|3x0-0|3x0-0|3x0-0|3x0-0|3x0-0|3x0-0|3x0-0|3x0-0|3x0-0|3x0-0|3x0-0|3x0-0|0x0-1|
0x0-1|3x0-0|3x0-0|3x0-0|3x0-0|3x0-0|3x0-0|3x0-0|3x0-0|3x0-0|3x0-0|3x0-0|3x0-0|3x0-0|3x0-0|3x0-0|3x0-0|3x0-0|3x0-0|3x0-0|3x0-0|3x0-0|3x0-0|3x0-0|3x0-0|3x0-0|3x0-0|3x0-0|3x0-0|3x0-0|3x0-0|3x0-0|3x0-0|3x0-0|3x0-0|3x0-0|3x0-0|3x0-0|3x0-0|3x0-0|3x0-0|3x0-0|3x0-0|3x0-0|3x0-0|3x0-0|3x0-0|3x0-0|3x0-0|3x0-0|3x0-0|3x0-0|3x0-0|3x0-0|3x0-0|3x0-0|3x0-0|3x0-0|3x0-0|3x0-0|3x0-0|3x0-0|3x0-0|3x0-0|3x0-0|3x0-0|3x0-0|3x0-0|3x0-0|3x0-0|3x0-0|3x0-0|3x0-0|3x0-0|3x0-0|3x0-0|3x0-0|3x0-0|3x0-0|0x0-1|
0x0-1|3x0-0|3x0-0|3x0-0|3x0-0|3x0-0|3x0-0|3x0-0|3x0-0|3x0-0|3x0-0|3x0-0|3x0-0|3x0-0|3x0-0|3x0-0|3x0-0|3x0-0|3x0-0|3x0-0|3x0-0|3x0-0|3x0-0|3x0-0|3x0-0|3x0-0|3x0-0|3x0-0|3x0-0|3x0-0|3x0-0|3x0-0|3x0-0|3x0-0|3x0-0|3x0-0|3x0-0|3x0-0|3x0-0|3x0-0|3x0-0|3x0-0|3x0-0|3x0-0|3x0-0|3x0-0|3x0-0|3x0-0|3x0-0|3x0-0|3x0-0|3x0-0|3x0-0|3x0-0|3x0-0|3x0-0|3x0-0|3x0-0|3x0-0|3x0-0|3x0-0|3x0-0|3x0-0|3x0-0|3x0-0|3x0-0|3x0-0|3x0-0|3x0-0|3x0-0|3x0-0|3x0-0|3x0-0|3x0-0|3x0-0|3x0-0|3x0-0|3x0-0|3x0-0|0x0-1|
0x0-1|3x0-0|3x0-0|3x0-0|3x0-0|3x0-0|3x0-0|3x0-0|3x0-0|3x0-0|3x0-0|3x0-0|3x0-0|3x0-0|3x0-0|3x0-0|3x0-0|3x0-0|3x0-0|3x0-0|3x0-0|3x0-0|3x0-0|3x0-0|3x0-0|3x0-0|3x0-0|3x0-0|3x0-0|3x0-0|3x0-0|3x0-0|3x0-0|3x0-0|3x0-0|3x0-0|3x0-0|3x0-0|3x0-0|3x0-0|3x0-0|3x0-0|3x0-0|3x0-0|3x0-0|3x0-0|3x0-0|3x0-0|3x0-0|3x0-0|3x0-0|3x0-0|3x0-0|3x0-0|3x0-0|3x0-0|3x0-0|3x0-0|3x0-0|3x0-0|3x0-0|3x0-0|3x0-0|3x0-0|3x0-0|3x0-0|3x0-0|3x0-0|3x0-0|3x0-0|3x0-0|3x0-0|3x0-0|3x0-0|3x0-0|3x0-0|3x0-0|3x0-0|3x0-0|0x0-1|
0x0-1|3x0-0|3x0-0|3x0-0|3x0-0|3x0-0|3x0-0|3x0-0|3x0-0|3x0-0|3x0-0|3x0-0|3x0-0|3x0-0|3x0-0|3x0-0|3x0-0|3x0-0|3x0-0|3x0-0|3x0-0|3x0-0|3x0-0|3x0-0|3x0-0|3x0-0|3x0-0|3x0-0|3x0-0|3x0-0|3x0-0|3x0-0|3x0-0|3x0-0|3x0-0|3x0-0|3x0-0|3x0-0|3x0-0|0x0-1|0x0-1|3x0-0|3x0-0|3x0-0|3x0-0|3x0-0|3x0-0|3x0-0|3x0-0|3x0-0|3x0-0|3x0-0|3x0-0|3x0-0|3x0-0|3x0-0|3x0-0|3x0-0|3x0-0|3x0-0|3x0-0|3x0-0|3x0-0|3x0-0|3x0-0|3x0-0|3x0-0|3x0-0|3x0-0|3x0-0|3x0-0|3x0-0|3x0-0|3x0-0|3x0-0|3x0-0|3x0-0|3x0-0|3x0-0|0x0-1|
0x0-1|3x0-0|3x0-0|3x0-0|3x0-0|3x0-0|3x0-0|3x0-0|3x0-0|3x0-0|3x0-0|3x0-0|3x0-0|3x0-0|3x0-0|3x0-0|3x0-0|3x0-0|3x0-0|3x0-0|3x0-0|3x0-0|3x0-0|3x0-0|3x0-0|3x0-0|3x0-0|3x0-0|3x0-0|3x0-0|3x0-0|3x0-0|3x0-0|3x0-0|3x0-0|3x0-0|3x0-0|3x0-0|3x0-0|0x0-1|0x0-1|3x0-0|3x0-0|3x0-0|3x0-0|3x0-0|3x0-0|3x0-0|3x0-0|3x0-0|3x0-0|3x0-0|3x0-0|3x0-0|3x0-0|3x0-0|3x0-0|3x0-0|3x0-0|3x0-0|3x0-0|3x0-0|3x0-0|3x0-0|3x0-0|3x0-0|3x0-0|3x0-0|3x0-0|3x0-0|3x0-0|3x0-0|3x0-0|3x0-0|3x0-0|3x0-0|3x0-0|3x0-0|3x0-0|0x0-1|
0x0-1|3x0-0|3x0-0|3x0-0|3x0-0|3x0-0|3x0-0|3x0-0|3x0-0|3x0-0|3x0-0|3x0-0|3x0-0|3x0-0|3x0-0|3x0-0|3x0-0|3x0-0|3x0-0|3x0-0|3x0-0|3x0-0|3x0-0|3x0-0|3x0-0|3x0-0|3x0-0|3x0-0|3x0-0|3x0-0|3x0-0|3x0-0|3x0-0|3x0-0|3x0-0|3x0-0|3x0-0|3x0-0|3x0-0|0x0-1|0x0-1|3x0-0|3x0-0|3x0-0|3x0-0|3x0-0|3x0-0|3x0-0|3x0-0|3x0-0|3x0-0|3x0-0|3x0-0|3x0-0|3x0-0|3x0-0|3x0-0|3x0-0|3x0-0|3x0-0|3x0-0|3x0-0|3x0-0|3x0-0|3x0-0|3x0-0|3x0-0|3x0-0|3x0-0|3x0-0|3x0-0|3x0-0|3x0-0|3x0-0|3x0-0|3x0-0|3x0-0|3x0-0|3x0-0|0x0-1|
0x0-1|3x0-0|3x0-0|3x0-0|3x0-0|3x0-0|3x0-0|3x0-0|3x0-0|3x0-0|3x0-0|3x0-0|3x0-0|3x0-0|3x0-0|3x0-0|3x0-0|3x0-0|3x0-0|3x0-0|3x0-0|3x0-0|3x0-0|3x0-0|3x0-0|3x0-0|3x0-0|3x0-0|3x0-0|3x0-0|3x0-0|3x0-0|3x0-0|3x0-0|3x0-0|3x0-0|3x0-0|3x0-0|3x0-0|0x0-1|0x0-1|3x0-0|3x0-0|3x0-0|3x0-0|3x0-0|3x0-0|3x0-0|3x0-0|3x0-0|3x0-0|3x0-0|3x0-0|3x0-0|3x0-0|3x0-0|3x0-0|3x0-0|3x0-0|3x0-0|3x0-0|3x0-0|3x0-0|3x0-0|3x0-0|3x0-0|3x0-0|3x0-0|3x0-0|3x0-0|3x0-0|3x0-0|3x0-0|3x0-0|3x0-0|3x0-0|3x0-0|3x0-0|3x0-0|0x0-1|
0x0-1|3x0-0|3x0-0|3x0-0|3x0-0|3x0-0|3x0-0|3x0-0|3x0-0|3x0-0|3x0-0|3x0-0|3x0-0|3x0-0|3x0-0|3x0-0|3x0-0|3x0-0|3x0-0|3x0-0|3x0-0|3x0-0|3x0-0|3x0-0|3x0-0|3x0-0|3x0-0|3x0-0|3x0-0|3x0-0|3x0-0|3x0-0|3x0-0|3x0-0|3x0-0|3x0-0|3x0-0|3x0-0|3x0-0|0x0-1|0x0-1|3x0-0|3x0-0|3x0-0|3x0-0|3x0-0|3x0-0|3x0-0|3x0-0|3x0-0|3x0-0|3x0-0|3x0-0|3x0-0|3x0-0|3x0-0|3x0-0|3x0-0|3x0-0|3x0-0|3x0-0|3x0-0|3x0-0|3x0-0|3x0-0|3x0-0|3x0-0|3x0-0|3x0-0|3x0-0|3x0-0|3x0-0|3x0-0|3x0-0|3x0-0|3x0-0|3x0-0|3x0-0|3x0-0|0x0-1|
0x0-1|3x0-0|3x0-0|3x0-0|3x0-0|3x0-0|3x0-0|3x0-0|3x0-0|3x0-0|3x0-0|3x0-0|3x0-0|3x0-0|3x0-0|3x0-0|3x0-0|3x0-0|3x0-0|3x0-0|3x0-0|3x0-0|3x0-0|3x0-0|3x0-0|3x0-0|3x0-0|3x0-0|3x0-0|3x0-0|3x0-0|3x0-0|3x0-0|3x0-0|3x0-0|3x0-0|3x0-0|3x0-0|3x0-0|0x0-1|0x0-1|3x0-0|3x0-0|3x0-0|3x0-0|3x0-0|3x0-0|3x0-0|3x0-0|3x0-0|3x0-0|3x0-0|3x0-0|3x0-0|3x0-0|3x0-0|3x0-0|3x0-0|3x0-0|3x0-0|3x0-0|3x0-0|3x0-0|3x0-0|3x0-0|3x0-0|3x0-0|3x0-0|3x0-0|3x0-0|3x0-0|3x0-0|3x0-0|3x0-0|3x0-0|3x0-0|3x0-0|3x0-0|3x0-0|0x0-1|
0x0-1|3x0-0|3x0-0|3x0-0|3x0-0|3x0-0|3x0-0|3x0-0|3x0-0|3x0-0|3x0-0|3x0-0|3x0-0|3x0-0|3x0-0|3x0-0|3x0-0|3x0-0|3x0-0|3x0-0|3x0-0|3x0-0|3x0-0|3x0-0|3x0-0|3x0-0|3x0-0|3x0-0|3x0-0|3x0-0|3x0-0|3x0-0|3x0-0|3x0-0|3x0-0|3x0-0|3x0-0|3x0-0|3x0-0|0x0-1|0x0-1|3x0-0|3x0-0|3x0-0|3x0-0|3x0-0|3x0-0|3x0-0|3x0-0|3x0-0|3x0-0|3x0-0|3x0-0|3x0-0|3x0-0|3x0-0|3x0-0|3x0-0|3x0-0|3x0-0|3x0-0|3x0-0|3x0-0|3x0-0|3x0-0|3x0-0|3x0-0|3x0-0|3x0-0|3x0-0|3x0-0|3x0-0|3x0-0|3x0-0|3x0-0|3x0-0|3x0-0|3x0-0|3x0-0|0x0-1|
0x0-1|3x0-0|3x0-0|3x0-0|3x0-0|3x0-0|3x0-0|3x0-0|3x0-0|3x0-0|3x0-0|3x0-0|3x0-0|3x0-0|3x0-0|3x0-0|3x0-0|3x0-0|3x0-0|3x0-0|3x0-0|3x0-0|3x0-0|3x0-0|3x0-0|3x0-0|3x0-0|3x0-0|3x0-0|3x0-0|3x0-0|3x0-0|3x0-0|3x0-0|3x0-0|3x0-0|3x0-0|3x0-0|3x0-0|0x0-1|0x0-1|3x0-0|3x0-0|3x0-0|3x0-0|3x0-0|3x0-0|3x0-0|3x0-0|3x0-0|3x0-0|3x0-0|3x0-0|3x0-0|3x0-0|3x0-0|3x0-0|3x0-0|3x0-0|3x0-0|3x0-0|3x0-0|3x0-0|3x0-0|3x0-0|3x0-0|3x0-0|3x0-0|3x0-0|3x0-0|3x0-0|3x0-0|3x0-0|3x0-0|3x0-0|3x0-0|3x0-0|3x0-0|3x0-0|0x0-1|
0x0-1|3x0-0|3x0-0|3x0-0|3x0-0|3x0-0|3x0-0|3x0-0|3x0-0|3x0-0|3x0-0|3x0-0|3x0-0|3x0-0|3x0-0|3x0-0|3x0-0|3x0-0|3x0-0|3x0-0|3x0-0|3x0-0|3x0-0|3x0-0|3x0-0|3x0-0|3x0-0|3x0-0|3x0-0|3x0-0|3x0-0|3x0-0|3x0-0|3x0-0|3x0-0|3x0-0|3x0-0|3x0-0|3x0-0|0x0-1|0x0-1|3x0-0|3x0-0|3x0-0|3x0-0|3x0-0|3x0-0|3x0-0|3x0-0|3x0-0|3x0-0|3x0-0|3x0-0|3x0-0|3x0-0|3x0-0|3x0-0|3x0-0|3x0-0|3x0-0|3x0-0|3x0-0|3x0-0|3x0-0|3x0-0|3x0-0|3x0-0|3x0-0|3x0-0|3x0-0|3x0-0|3x0-0|3x0-0|3x0-0|3x0-0|3x0-0|3x0-0|3x0-0|3x0-0|0x0-1|
0x0-1|3x0-0|3x0-0|3x0-0|3x0-0|3x0-0|3x0-0|3x0-0|3x0-0|3x0-0|3x0-0|3x0-0|3x0-0|3x0-0|3x0-0|3x0-0|3x0-0|3x0-0|3x0-0|3x0-0|3x0-0|3x0-0|3x0-0|3x0-0|3x0-0|3x0-0|3x0-0|3x0-0|3x0-0|3x0-0|3x0-0|3x0-0|3x0-0|3x0-0|3x0-0|3x0-0|3x0-0|3x0-0|3x0-0|0x0-1|0x0-1|3x0-0|3x0-0|3x0-0|3x0-0|3x0-0|3x0-0|3x0-0|3x0-0|3x0-0|3x0-0|3x0-0|3x0-0|3x0-0|3x0-0|3x0-0|3x0-0|3x0-0|3x0-0|3x0-0|3x0-0|3x0-0|3x0-0|3x0-0|3x0-0|3x0-0|3x0-0|3x0-0|3x0-0|3x0-0|3x0-0|3x0-0|3x0-0|3x0-0|3x0-0|3x0-0|3x0-0|3x0-0|3x0-0|0x0-1|
0x0-1|3x0-0|3x0-0|3x0-0|3x0-0|3x0-0|3x0-0|3x0-0|3x0-0|3x0-0|3x0-0|3x0-0|3x0-0|3x0-0|3x0-0|3x0-0|3x0-0|3x0-0|3x0-0|3x0-0|3x0-0|3x0-0|3x0-0|3x0-0|3x0-0|3x0-0|3x0-0|3x0-0|3x0-0|3x0-0|3x0-0|3x0-0|3x0-0|3x0-0|3x0-0|3x0-0|3x0-0|3x0-0|3x0-0|0x0-1|0x0-1|3x0-0|3x0-0|3x0-0|3x0-0|3x0-0|3x0-0|3x0-0|3x0-0|3x0-0|3x0-0|3x0-0|3x0-0|3x0-0|3x0-0|3x0-0|3x0-0|3x0-0|3x0-0|3x0-0|3x0-0|3x0-0|3x0-0|3x0-0|3x0-0|3x0-0|3x0-0|3x0-0|3x0-0|3x0-0|3x0-0|3x0-0|3x0-0|3x0-0|3x0-0|3x0-0|3x0-0|3x0-0|3x0-0|0x0-1|
0x0-1|3x0-0|3x0-0|3x0-0|3x0-0|3x0-0|3x0-0|3x0-0|3x0-0|3x0-0|3x0-0|3x0-0|3x0-0|3x0-0|3x0-0|3x0-0|3x0-0|3x0-0|3x0-0|3x0-0|3x0-0|3x0-0|3x0-0|3x0-0|3x0-0|3x0-0|3x0-0|3x0-0|3x0-0|3x0-0|3x0-0|3x0-0|3x0-0|3x0-0|3x0-0|3x0-0|3x0-0|3x0-0|3x0-0|0x0-1|0x0-1|3x0-0|3x0-0|3x0-0|3x0-0|3x0-0|3x0-0|3x0-0|3x0-0|3x0-0|3x0-0|3x0-0|3x0-0|3x0-0|3x0-0|3x0-0|3x0-0|3x0-0|3x0-0|3x0-0|3x0-0|3x0-0|3x0-0|3x0-0|3x0-0|3x0-0|3x0-0|3x0-0|3x0-0|3x0-0|3x0-0|3x0-0|3x0-0|3x0-0|3x0-0|3x0-0|3x0-0|3x0-0|3x0-0|0x0-1|
0x0-1|3x0-0|3x0-0|3x0-0|3x0-0|3x0-0|3x0-0|3x0-0|3x0-0|3x0-0|3x0-0|3x0-0|3x0-0|3x0-0|3x0-0|3x0-0|3x0-0|3x0-0|3x0-0|3x0-0|3x0-0|3x0-0|3x0-0|3x0-0|3x0-0|3x0-0|3x0-0|3x0-0|3x0-0|3x0-0|3x0-0|3x0-0|3x0-0|3x0-0|3x0-0|3x0-0|3x0-0|3x0-0|3x0-0|0x0-1|0x0-1|3x0-0|3x0-0|3x0-0|3x0-0|3x0-0|3x0-0|3x0-0|3x0-0|3x0-0|3x0-0|3x0-0|3x0-0|3x0-0|3x0-0|3x0-0|3x0-0|3x0-0|3x0-0|3x0-0|3x0-0|3x0-0|3x0-0|3x0-0|3x0-0|3x0-0|3x0-0|3x0-0|3x0-0|3x0-0|3x0-0|3x0-0|3x0-0|3x0-0|3x0-0|3x0-0|3x0-0|3x0-0|3x0-0|0x0-1|
0x0-1|3x0-0|3x0-0|3x0-0|3x0-0|3x0-0|3x0-0|3x0-0|3x0-0|3x0-0|3x0-0|3x0-0|3x0-0|3x0-0|3x0-0|3x0-0|3x0-0|3x0-0|3x0-0|3x0-0|3x0-0|3x0-0|3x0-0|3x0-0|3x0-0|3x0-0|3x0-0|3x0-0|3x0-0|3x0-0|3x0-0|3x0-0|3x0-0|3x0-0|3x0-0|3x0-0|3x0-0|3x0-0|3x0-0|0x0-1|0x0-1|3x0-0|3x0-0|3x0-0|3x0-0|3x0-0|3x0-0|3x0-0|3x0-0|3x0-0|3x0-0|3x0-0|3x0-0|3x0-0|3x0-0|3x0-0|3x0-0|3x0-0|3x0-0|3x0-0|3x0-0|3x0-0|3x0-0|3x0-0|3x0-0|3x0-0|3x0-0|3x0-0|3x0-0|3x0-0|3x0-0|3x0-0|3x0-0|3x0-0|3x0-0|3x0-0|3x0-0|3x0-0|3x0-0|0x0-1|
0x0-1|3x0-0|3x0-0|3x0-0|3x0-0|3x0-0|3x0-0|3x0-0|3x0-0|3x0-0|3x0-0|3x0-0|3x0-0|3x0-0|3x0-0|3x0-0|3x0-0|3x0-0|3x0-0|3x0-0|3x0-0|3x0-0|3x0-0|3x0-0|3x0-0|3x0-0|3x0-0|3x0-0|3x0-0|3x0-0|3x0-0|3x0-0|3x0-0|3x0-0|3x0-0|3x0-0|3x0-0|3x0-0|3x0-0|0x0-1|0x0-1|3x0-0|3x0-0|3x0-0|3x0-0|3x0-0|3x0-0|3x0-0|3x0-0|3x0-0|3x0-0|3x0-0|3x0-0|3x0-0|3x0-0|3x0-0|3x0-0|3x0-0|3x0-0|3x0-0|3x0-0|3x0-0|3x0-0|3x0-0|3x0-0|3x0-0|3x0-0|3x0-0|3x0-0|3x0-0|3x0-0|3x0-0|3x0-0|3x0-0|3x0-0|3x0-0|3x0-0|3x0-0|3x0-0|0x0-1|
0x0-1|3x0-0|3x0-0|3x0-0|3x0-0|3x0-0|3x0-0|3x0-0|3x0-0|3x0-0|3x0-0|3x0-0|3x0-0|3x0-0|3x0-0|3x0-0|3x0-0|3x0-0|3x0-0|3x0-0|3x0-0|3x0-0|3x0-0|3x0-0|3x0-0|3x0-0|3x0-0|3x0-0|3x0-0|3x0-0|3x0-0|3x0-0|3x0-0|3x0-0|3x0-0|3x0-0|3x0-0|3x0-0|3x0-0|0x0-1|0x0-1|3x0-0|3x0-0|3x0-0|3x0-0|3x0-0|3x0-0|3x0-0|3x0-0|3x0-0|3x0-0|3x0-0|3x0-0|3x0-0|3x0-0|3x0-0|3x0-0|3x0-0|3x0-0|3x0-0|3x0-0|3x0-0|3x0-0|3x0-0|3x0-0|3x0-0|3x0-0|3x0-0|3x0-0|3x0-0|3x0-0|3x0-0|3x0-0|3x0-0|3x0-0|3x0-0|3x0-0|3x0-0|3x0-0|0x0-1|
0x0-1|0x0-1|0x0-1|0x0-1|0x0-1|0x0-1|0x0-1|0x0-1|0x0-1|0x0-1|0x0-1|0x0-1|0x0-1|0x0-1|0x0-1|0x0-1|0x0-1|0x0-1|0x0-1|0x0-1|0x0-1|0x0-1|0x0-1|0x0-1|0x0-1|0x0-1|0x0-1|0x0-1|0x0-1|0x0-1|0x0-1|0x0-1|0x0-1|0x0-1|0x0-1|0x0-1|0x0-1|0x0-1|0x0-1|0x0-1|0x0-1|0x0-1|0x0-1|0x0-1|0x0-1|0x0-1|0x0-1|0x0-1|0x0-1|0x0-1|0x0-1|0x0-1|0x0-1|0x0-1|0x0-1|0x0-1|0x0-1|0x0-1|0x0-1|0x0-1|0x0-1|0x0-1|0x0-1|0x0-1|0x0-1|0x0-1|0x0-1|0x0-1|0x0-1|0x0-1|0x0-1|0x0-1|0x0-1|0x0-1|0x0-1|0x0-1|0x0-1|0x0-1|0x0-1|0x0-1|